Tasha	Gino
Wendy	Gino
Randy	Katrina
Olina	Katrina
Peggy	Katrina
Jean	Katrina
Charlotte	Katrina
Christina	Katrina
Andrea	Harrison
Duke	Harrison
Cosmo	Harrison
Enterprise	Harrison
Johnny	Christine
Gabriel	Christine
Garfield	Christine
Cole	Christine
Terry	Christine
Ingrid	Christine
Chloe	Christine
Stephanie	Christine
Mandy	Josephine
Nikita	Josephine
Madeline	Serena
Rock	Serena
Julie	Colin
Sharon	Colin
Ophelia	Robert
Reed	Robert
Kenny	Robert
Hilton	Robert
Alexandra	Serena
Miriam	Serena
Dick	Serena
Elaine	Serena
Luke	Eugene
Daniel	Eugene
Stewart	Eugene
Cliff	Eugene
Zachary	Eugene
Leonard	Eugene
Owen	John
Selina	Jesse
Eric	Jesse
Elijah	Yvonne
Karida	Yvonne
Hugo	Yvonne
Marilyn	Yvonne
Jimmy	Anita
Flta	Ryan
Jenny	Ryan
Morgan	John
Harry	Jesse
Ellie	Jesse
Christian	Jesse
Lassie	Bob
Chelsea	Jesse
Cherry	Jesse
Billy	Warner
Van	Warner
Matthew	Warner
Riley	Donald
Marks	Donald
Emily	Donald
Evan	Donald
Lily	Ted
Abby	Ted
Ben	Ted
Paula	Ted
April	Ted
Isaiah	Emma
Tammy	Emma
Mickey	Emma
Rachel	Rose
Melinda	Rose
Hillary	Rose
Alan	Josephine
Lorraine	Josephine
Eddie	Josephine
Yvette	Josephine
Alva	Josephine
Edward	Josephine
Cindy	Josephine
Cassie	Josephine
Steve	Eugene
Ivy	Eugene
Sheila	Eugene
Lora	Eugene
Hardy	Yvonne
Ray	Yvonne
Franklin	Mabel
Marvin	Mabel
Kelsey	Mabel
Leander	Mabel
Shirley	Mabel
Helena	Mabel
Selma	Josephine
Annie	Josephine
Tony	Josephine
Brant	Ted
Edmund	Ted
Lee	Constance
Candice	Constance
Oprah	Frieda
Gaby	Frieda
Vern	Anita
Alfred	Anita
Sarah	Anita
Adelaide	Anita
Charles	Anita
Solomon	Evelyn
Yolanda	Evelyn
Roxanne	Evelyn
Oliver	Evelyn
Juliana	Donald
Amy	Joe
Florence	Joe
Hebe	Joe
Connie	Philomena
Randolph	Philomena
Warren	Ryan
Jasmine	Lydia
Sherry	Lydia
Ashley	Lydia
Sabrina	Lydia
Ariel	Lydia
Octavia	Vincent
Julia	Vincent
Ultraman	Lydia
Mariah	Lydia
Vanessa	Lydia
Nelson	Lydia
Erica	Randall
Natasha	Randall
Ronald	Randall
Alice	Randall
Fay	Randall
Debra	Randall
Neil	Randall
Vivian	Mabel
Lareina	Mabel
Iris	Mabel
Pearl	Mabel
Larry	Mabel
Jamie	Mabel
Joshua	Mabel
Daphne	Mabel
Quentin	Ruth
Carina	Ruth
Rowan	Ruth
Stacy	Ruth
Mary	Ruth
Amber	Patty
Kathy	Patty
Anne	Randall
Meredith	Randall
Michelle	Patty
Mercedes	Patty
Ada	Patty
Spencer	Albert
Aviva	Albert
Timothy	Albert
Enid	Albert
Fannie	Albert
Sonia	Albert
Nicole	Josephine
Dora	Josephine
Angelina	Josephine
Todd	Leslie
Melissa	Leslie
Bonnie	Leslie
Ivan	Leslie
Pauline	Leslie
Jerome	Elliott
Jocelyn	Elliott
Ignativs	Elliott
Scott	Robert
Nina	Greta
Cathy	Greta
Lucia	Greta
Beatrice	Patty
lindsay	Patty
Megan	Patty
Jeffery	Patty
Lynn	Shelley
Victoria	Shelley
Mia	Shelley
Judith	Shelley
Fiona	Shelley
Elsa	Shelley
Quentina	Greta
Ishara	Greta
Michael	Greta
Laura	Greta
Sierra	Greta
Wayne	Jennifer
Jack	Jennifer
Henry	Jennifer
Paul	Jennifer
Jay	Jennifer
Lucy	Jennifer
Haley	Shelley
Samantha	Shelley
Alex	Shelley
Roy	Shelley
Debbie	Shelley
August	Josephine
George	Josephine
Carry	Robinson
Cloris	Robinson
Allison	Robinson
Milly	Robinson
Aidan	Carrie
Lorin	Jennifer
Terence	Anita
Ken	Anita
Samuel	Jennifer
Leo	Jennifer
Victor	Jennifer
Francis	Constance
Cassandra	Constance
Linda	Constance
Stella	Constance
Vernon	Rose
Tracy	Rose
Sandra	Rose
Joy	Rose
Frank	Rose
Angel	Ryan
Kelly	Ryan
Claire	Ryan
Aaron	Eleanor
Robin	Eleanor
Jessica	Carrie
Stuart	Carrie
Jose	Eleanor
Mamie	Leslie
Becky	Leslie
Miya	Ruth
Howard	Ruth
Sue	Ruth
Lori	Robinson
Ailsa	Robinson
Zack	Robinson
Joan	Robinson
Phyllis	Ted
Alexander	Ted
Sam	Ted
Christopher	Ted
Jane	Ted
Mason	Ted
Andy	Philomena
Angus	Philomena
Gary	Philomena
Flora	Philomena
Henna	Philomena
Richard	Eleanor
Sammy	Eleanor
Virginia	Eleanor
Norman	Rose
Dave	Mabel
Steven	Mabel
Anastasia	Colin
Raymond	Harrison
Cameron	Harrison
Kyle	Harrison
Tess	Harrison
Angela	Colin
Clark	Christine
Ellen	Philomena
Cary	Philomena
Max	Philomena
Dylan	Philomena
Joyce	Philomena
Esther	Donald
Laurent	Donald
Sidney	Donald
Sophia	Ruth
Jordan	Ruth
Sunny	Ruth
Gladys	Elliott
Scarlett	Elliott
Ian	Elliott
Eudora	Elliott
Sandy	Donald
Edwin	Donald
Chris	Donald
Kitty	Evelyn
Zelda	Evelyn
Arnold	Evelyn
Martin	Evelyn
David	Evelyn
Gavin	John
Brent	John
Jacob	Robinson
Zoey	Robinson
Diana	Robinson
Denny	Robinson
Claudia	Robinson
Marcus	Eve
Louise	Eve
Liz	Eve
Clement	Rose
Jessie	Rose
Richie	Serena
Jim	Serena
Wanda	Margaret
Bess	Margaret
Demi	Margaret
Glen	Margaret
Spike	Lydia
Shawn	Lydia
Gloria	Lydia
Loren	Lydia
Jackson	Lydia
Blanche	Lydia
Violet	Lydia
William	Lydia
Estelle	Robinson
Kayla	Robinson
Gina	Robinson
Donna	Jennifer
Irene	Jennifer
Pamela	Jennifer
Isaac	Jennifer
Lauren	Rose
Tyler	Rose
Willy	Rose
Mark	Robert
Louisa	Lydia
Vita	Lydia
Anthony	Lydia
Rebecca	Ted
Brenda	Ted
Eva	Evelyn
Austin	Evelyn
Judy	Evelyn
Maggie	Greta
Audrey	Eugene
Susan	Eugene
Bella	Eugene
Barbara	Ryan
Kennedy	Ryan
Alina	Ryan
Brad	Ryan
Sami	Ryan
Barbie	Vincent
Adeline	Vincent
Rex	Vincent
Ella	John
Joliet	Ryan
Jacqueline	Ryan
Alyssa	Ryan
Nora	Randall
Katie	Randall
Phoebe	Randall
Tom	Harrison
Patrick	Harrison
Nathan	Harrison
Crystal	Randall
Manda	Randall
Vera	Randall
Fred	Emma
Gillian	Emma
Justin	Emma
Lillian	Emma
Daisy	Bob
Tanya	Greta
Angelia	Greta
Jill	Robinson
Noah	Robinson
Jerry	Robinson
Kimberly	Brown
Heidi	Brown
Katherine	Brown
Hank	Brown
Elvis	Carrie
Tina	Carrie
Andrew	Carrie
Jenna	Josephine
Miranda	Josephine
Rita	Josephine
Nathaniel	Josephine
Natalie	Leslie
Bruce	Leslie
Hunk	Leslie
Janet	Geoffrey
Christy	Geoffrey
Darcy	Geoffrey
